20 20
11111011111111111110
11000001111100001110
11000001111000000110
11100111111100110111
11111111111110111111
11111111111111111111
11111110000111111111
11111111000000011111
11111111101011011111
11111111100011111111
11111111111111111111
11111111111111111111
11110111111111111111
11110000001111111111
11100000111111111111
11110001111111111111
11100000110011011111
11000000000001111111
11110000000000111111
11101111111111111111
