11111011111111111111
11000001111100001111
11000001111000000111
11100111111100110111
11111111111110111111
11111111111111111111
11111110000111111111
11111111000000011111
11111111101011011111
11111111100011111111

