1111101111
1100000111
1100000111
1110011111
1111111111